1111111111
1P00010001
1110010001
1000010001
1C00000001
1000100001
1110100001
1000101111
1000000001
1111111111