1111111111
1000010001
1110010001
1000010001
1000000001
1000100P01
1110100C01
1000101111
10000000E1
1111111111