1111111111
1000010001
1110010001
1000010001
1000000001
1000100001
1110100001
1000101111
1000PC00E1
1111111111