1111111111
1000010001
1110010001
100C010001
1000000001
1000100001
111C100001
1000101111
10P0C000E1
1111111111