1111111111
1P0001E101
1000000001
1000000001
1000110001
100010C001
1010100001
1010C00001
1000000C01
1111111111